تولیدی‌اش	تولیدی	تولیدی	اش
محبوبشان	محبوب	محبوب	شان
اخیرش	اخیر	اخیر	ش
بشردوستانه‌اش	بشردوستانه	بشردوستانه	اش
رنگ‌به‌رنگشان	رنگ‌به‌رنگ	رنگ‌به‌رنگ	شان
ظریفشان	ظریف	ظریف	شان
گرامیتان	گرامی	گرامی	تان
شخصی‌ام	شخصی	شخصی	ام
منفی‌ام	منفی	منفی	ام
خوشم	خوش	خوش	م
ذهنی‌ام	ذهنی	ذهنی	ام
جنسیتیشان	جنسیتی	جنسیتی	شان
تلفنی‌اش	تلفنی	تلفنی	اش
جدیدش	جدید	جدید	ش
قدیمی‌ام	قدیمی	قدیمی	ام
نهایی‌اش	نهایی	نهایی	اش
مالی‌مان	مالی	مالی	مان
نهایی‌اش	نهایی	نهایی	اش
مردانه‌ام	مردانه	مردانه	ام
طرفدارش	طرفدار	طرفدار	ش
سمجم	سمج	سمج	م
فکری‌ام	فکری	فکری	ام
زیبایت	زیبا	زیبا	یت
عزیزم	عزیز	عزیز	م
طاهرینم	طاهرین	طاهرین	م
دریایی‌اش	دریایی	دریایی	اش
دریافتی‌ام	دریافتی	دریافتی	ام
خوشش	خوش	خوش	ش
نوینتان	نوین	نوین	تان
دیپلماتیکمان	دیپلماتیک	دیپلماتیک	مان
مهربانم	مهربان	مهربان	م
دیگرش	دیگر	دیگر	ش
سبزش	سبز	سبز	ش
رنگ‌پریده‌اش	رنگ‌پریده	رنگ‌پریده	اش
مستعارش	مستعار	مستعار	ش
کارگری‌ام	کارگری	کارگری	ام
بی‌رمقم	بی‌رمق	بی‌رمق	م
پایینش	پایین	پایین	ش
حسرت‌بارش	حسرت‌بار	حسرت‌بار	ش
سردم	سرد	سرد	م
محقرم	محقر	محقر	م
پیدایم	پیدا	پیدا	یم
کاذبم	کاذب	کاذب	م
بیچاره‌ام	بیچاره	بیچاره	ام
گرمم	گرم	گرم	م
تشریعی‌اش	تشریعی	تشریعی	اش
داستانی‌اش	داستانی	داستانی	اش
کوتاهتان	کوتاه	کوتاه	تان
آخرتان	آخر	آخر	تان
تخصصی‌اش	تخصصی	تخصصی	اش
سینمایی‌اش	سینمایی	سینمایی	اش
خانوادگی‌اش	خانوادگی	خانوادگی	اش
درخشانش	درخشان	درخشان	ش
خوشتان	خوش	خوش	تان
آسمانی‌ام	آسمانی	آسمانی	ام
پاکشان	پاک	پاک	شان
بی‌تابم	بی‌تاب	بی‌تاب	م
خیالیشان	خیالی	خیالی	شان
ناخوشایندشان	ناخوشایند	ناخوشایند	شان
قلبی‌اش	قلبی	قلبی	اش
همراهم	همراه	همراه	م
فروخورده‌ام	فروخورده	فروخورده	ام
سرکشم	سرکش	سرکش	م
کوچکش	کوچک	کوچک	ش
بی‌قرارشان	بی‌قرار	بی‌قرار	شان
همراهمان	همراه	همراه	مان
عقبش	عقب	عقب	ش
دستی‌ام	دستی	دستی	ام
دستی‌اش	دستی	دستی	اش
راستش	راست	راست	ش
کوچکشان	کوچک	کوچک	شان
زیبایش	زیبا	زیبا	یش
پرمهرتان	پرمهر	پرمهر	تان
متبرکت	متبرک	متبرک	ت
گره‌دارش	گره‌دار	گره‌دار	ش
بانشاطش	بانشاط	بانشاط	ش
آسمانیشان	آسمانی	آسمانی	شان
بسته‌ام	بسته	بسته	ام
گم‌شده‌ام	گم‌شده	گم‌شده	ام
بازآورده‌اش	بازآورده	بازآورده	اش
مشترکمان	مشترک	مشترک	مان
قدیمی‌مان	قدیمی	قدیمی	مان
شومشان	شوم	شوم	شان
انسانیشان	انسانی	انسانی	شان
اندکمان	اندک	اندک	مان
مبارکتان	مبارک	مبارک	تان
مبارکش	مبارک	مبارک	ش
خوشبویمان	خوشبو	خوشبو	یمان
جدیدش	جدید	جدید	ش
مشابهش	مشابه	مشابه	ش
پنهانت	پنهان	پنهان	ت
سینمایی‌شان	سینمایی	سینمایی	شان
نافذش	نافذ	نافذ	ش
ناتوانم	ناتوان	ناتوان	م
زیبایش	زیبا	زیبا	یش
زشتشان	زشت	زشت	شان
پرگهرمان	پرگهر	پرگهر	مان
سرسبزمان	سرسبز	سرسبز	مان
گم‌شده‌شان	گم‌شده	گم‌شده	شان
شهیدش	شهید	شهید	ش
گره‌کرده‌اش	گره‌کرده	گره‌کرده	اش
خسته‌اش	خسته	خسته	اش
نمناکش	نمناک	نمناک	ش
شهیدش	شهید	شهید	ش
بلندم	بلند	بلند	م
لاغرم	لاغر	لاغر	م
بلندم	بلند	بلند	م
سنگینش	سنگین	سنگین	ش
ساله‌اش	ساله	ساله	اش
توحیدی‌ات	توحیدی	توحیدی	ات
خسته‌تان	خسته	خسته	تان
شیطانیتان	شیطانی	شیطانی	تان
همیشگی‌اش	همیشگی	همیشگی	اش
سیاهش	سیاه	سیاه	ش
مهربانش	مهربان	مهربان	ش
لطیفش	لطیف	لطیف	ش
دیگرت	دیگر	دیگر	ت
مرحومم	مرحوم	مرحوم	م
هم‌میهنم	هم‌میهن	هم‌میهن	م
واقعی‌اش	واقعی	واقعی	اش
سفیدشان	سفید	سفید	شان
چشمگیرش	چشمگیر	چشمگیر	ش
شخصیمان	شخصی	شخصی	مان
پوینده‌ات	پوینده	پوینده	ات
صدمه‌دیده‌اش	صدمه‌دیده	صدمه‌دیده	اش
دلنشینشان	دلنشین	دلنشین	شان
اجتماعی‌مان	اجتماعی	اجتماعی	مان
شومشان	شوم	شوم	شان
خسته‌ام	خسته	خسته	ام
پیشینشان	پیشین	پیشین	شان
مخفی‌اش	مخفی	مخفی	اش
سفیدش	سفید	سفید	ش
مالیاتیمان	مالیاتی	مالیاتی	مان
دشوارش	دشوار	دشوار	ش
جوانمان	جوان	جوان	مان
زیبایشان	زیبا	زیبا	یشان
تلفنی‌اش	تلفنی	تلفنی	اش
وجودیمان	وجودی	وجودی	مان
الهی‌اش	الهی	الهی	اش
خوش‌حالتش	خوش‌حالت	خوش‌حالت	ش
جدیدش	جدید	جدید	ش
جدیدت	جدید	جدید	ت
کوچکش	کوچک	کوچک	ش
نفتی‌اش	نفتی	نفتی	اش
کوچکم	کوچک	کوچک	م
مخربش	مخرب	مخرب	ش
مبارکش	مبارک	مبارک	ش
دلبندشان	دلبند	دلبند	شان
عالیات	عالی	عالی	ات
ساله‌شان	ساله	ساله	شان
مردانه‌اش	مردانه	مردانه	اش
بزرگوارش	بزرگوار	بزرگوار	ش
ماندگارش	ماندگار	ماندگار	ش
دیگرش	دیگر	دیگر	ش
تیره‌ام	تیره	تیره	ام
تازه‌تان	تازه	تازه	تان
پیش‌بینی‌شده‌اش	پیش‌بینی‌شده	پیش‌بینی‌شده	اش
خوششان	خوش	خوش	شان
خردسالش	خردسال	خردسال	ش
امروزیتان	امروزی	امروزی	تان
اعتباری‌اش	اعتباری	اعتباری	اش
ویرانمان	ویران	ویران	مان
بدبختمان	بدبخت	بدبخت	مان
ارزشمندشان	ارزشمند	ارزشمند	شان
زرینم	زرین	زرین	م
ضمیمه‌اش	ضمیمه	ضمیمه	اش
دستگیرش	دستگیر	دستگیر	ش
سختش	سخت	سخت	ش
دشوارش	دشوار	دشوار	ش
عاشقمان	عاشق	عاشق	مان
تراشیده‌اش	تراشیده	تراشیده	اش
چپش	چپ	چپ	ش
قدیمی‌اش	قدیمی	قدیمی	اش
پولدارش	پولدار	پولدار	ش
پف‌کرده‌اش	پف‌کرده	پف‌کرده	اش
قبلی‌ات	قبلی	قبلی	ات
زیبایت	زیبا	زیبا	یت
شش‌گانه‌اش	شش‌گانه	شش‌گانه	اش
شبانه‌اش	شبانه	شبانه	اش
واقعی‌اش	واقعی	واقعی	اش
معاصرش	معاصر	معاصر	ش
وقیحشان	وقیح	وقیح	شان
چربت	چرب	چرب	ت
عمومی‌اش	عمومی	عمومی	اش
شخصی‌اش	شخصی	شخصی	اش
شخصی‌اش	شخصی	شخصی	اش
ناخودآگاهمان	ناخودآگاه	ناخودآگاه	مان
ناخودآگاهمان	ناخودآگاه	ناخودآگاه	مان
خودآگاهمان	خودآگاه	خودآگاه	مان
ناخودآگاهش	ناخودآگاه	ناخودآگاه	ش
خودآگاهش	خودآگاه	خودآگاه	ش
بیمارگونه‌شان	بیمارگونه	بیمارگونه	شان
بازدارنده‌اش	بازدارنده	بازدارنده	اش
ناآرامش	ناآرام	ناآرام	ش
جدایی‌مان	جدایی	جدایی	مان
خوشش	خوش	خوش	ش
دلتنگت	دلتنگ	دلتنگ	ت
کشیده‌ات	کشیده	کشیده	ات
کنونیتان	کنونی	کنونی	تان
ماهانه‌مان	ماهانه	ماهانه	مان
آذریشان	آذری	آذری	شان
آمریکایی‌شان	آمریکایی	آمریکایی	شان
بلندش	بلند	بلند	ش
سرمه‌ای‌رنگش	سرمه‌ای‌رنگ	سرمه‌ای‌رنگ	ش
عزیزم	عزیز	عزیز	م
شخصیشان	شخصی	شخصی	شان
قانونی‌اش	قانونی	قانونی	اش
ساله‌ام	ساله	ساله	ام
گاه‌گاهیشان	گاه‌گاهی	گاه‌گاهی	شان
عزیزم	عزیز	عزیز	م
محبوبشان	محبوب	محبوب	شان
همیشگی‌ام	همیشگی	همیشگی	ام
بلندم	بلند	بلند	م
دیرینه‌اش	دیرینه	دیرینه	اش
سرشتیتان	سرشتی	سرشتی	تان
ناگسستنی‌ام	ناگسستنی	ناگسستنی	ام
عزیزمان	عزیز	عزیز	مان
خسته‌شان	خسته	خسته	شان
ناگزیرش	ناگزیر	ناگزیر	ش
اجتماعی‌مان	اجتماعی	اجتماعی	مان
لرزانش	لرزان	لرزان	ش
ناخودآگاهتان	ناخودآگاه	ناخودآگاه	تان
هدفمندمان	هدفمند	هدفمند	مان
راستش	راست	راست	ش
بسته‌ات	بسته	بسته	ات
رؤیایی‌اش	رؤیایی	رؤیایی	اش
نحیفش	نحیف	نحیف	ش
بدش	بد	بد	ش
برینم	برین	برین	م
محدودم	محدود	محدود	م
مؤمنش	مؤمن	مؤمن	ش
بی‌تفاوتش	بی‌تفاوت	بی‌تفاوت	ش
ساله‌اش	ساله	ساله	اش
مختلفش	مختلف	مختلف	ش
سردشان	سرد	سرد	شان
جسمی‌اش	جسمی	جسمی	اش
زیادش	زیاد	زیاد	ش
شامخش	شامخ	شامخ	ش
خوبم	خوب	خوب	م
چپم	چپ	چپ	م
کوچکم	کوچک	کوچک	م
کوتاهش	کوتاه	کوتاه	ش
کوچکش	کوچک	کوچک	ش
کوچکمان	کوچک	کوچک	مان
کمونیستی‌اش	کمونیستی	کمونیستی	اش
کوچکم	کوچک	کوچک	م
دلخواهتان	دلخواه	دلخواه	تان
شخصیشان	شخصی	شخصی	شان
قانونی‌اش	قانونی	قانونی	اش
نکره‌اش	نکره	نکره	اش
سیاهم	سیاه	سیاه	م
هکتاریشان	هکتاری	هکتاری	شان
مازادش	مازاد	مازاد	ش
گرامیشان	گرامی	گرامی	شان
عالیات	عالی	عالی	ات
بصری‌شان	بصری	بصری	شان
بلندش	بلند	بلند	ش
آهنی‌اش	آهنی	آهنی	اش
عزیزشان	عزیز	عزیز	شان
سپیدم	سپید	سپید	م
جدیدش	جدید	جدید	ش
تنگت	تنگ	تنگ	ت
بلندش	بلند	بلند	ش
قرمزش	قرمز	قرمز	ش
چپش	چپ	چپ	ش
وهمناکش	وهمناک	وهمناک	ش
کوچکم	کوچک	کوچک	م
ساله‌اش	ساله	ساله	اش
جدیدش	جدید	جدید	ش
مؤمنش	مؤمن	مؤمن	ش
حقیقی‌اش	حقیقی	حقیقی	اش
زشتم	زشت	زشت	م
ناقصش	ناقص	ناقص	ش
مقدسش	مقدس	مقدس	ش
بی‌کرانم	بی‌کران	بی‌کران	م
مجددش	مجدد	مجدد	ش
باوفایت	باوفا	باوفا	یت
هم‌وطنم	هم‌وطن	هم‌وطن	م
اوکراینی‌ام	اوکراینی	اوکراینی	ام
کودکانه‌ام	کودکانه	کودکانه	ام
تشکیل‌دهنده‌اش	تشکیل‌دهنده	تشکیل‌دهنده	اش
فراموشتان	فراموش	فراموش	تان
شخصی‌اش	شخصی	شخصی	اش
کاریشان	کاری	کاری	شان
غریبمان	غریب	غریب	مان
قدیمش	قدیم	قدیم	ش
آینده‌اش	آینده	آینده	اش
کمانگیرشان	کمانگیر	کمانگیر	شان
عزیزم	عزیز	عزیز	م
مشترکمان	مشترک	مشترک	مان
تاشده‌اش	تاشده	تاشده	اش
بزرگمان	بزرگ	بزرگ	مان
ملکوتیشان	ملکوتی	ملکوتی	شان
چپش	چپ	چپ	ش
راستش	راست	راست	ش
بلندش	بلند	بلند	ش
ننگینش	ننگین	ننگین	ش
جنگ‌طلبانه‌اش	جنگ‌طلبانه	جنگ‌طلبانه	اش
درسی‌ام	درسی	درسی	ام
حقوقی‌اش	حقوقی	حقوقی	اش
عزیزت	عزیز	عزیز	ت
تابناکش	تابناک	تابناک	ش
غربی‌اش	غربی	غربی	اش
ثروتمندش	ثروتمند	ثروتمند	ش
جایگیرتان	جایگیر	جایگیر	تان
مبنایی‌اش	مبنایی	مبنایی	اش
نریخته‌تان	نریخته	نریخته	تان
شیعی‌مان	شیعی	شیعی	مان
شومشان	شوم	شوم	شان
خیسش	خیس	خیس	ش
مدیریتی‌مان	مدیریتی	مدیریتی	مان
افتاده‌ام	افتاده	افتاده	ام
نشسته‌ات	نشسته	نشسته	ات
احمقانه‌شان	احمقانه	احمقانه	شان
ارجمندشان	ارجمند	ارجمند	شان
زیبایت	زیبا	زیبا	یت
خارجتان	خارج	خارج	تان
بیمارش	بیمار	بیمار	ش
سابقشان	سابق	سابق	شان
دیگرش	دیگر	دیگر	ش
کهنه‌ام	کهنه	کهنه	ام
اخلاقیتان	اخلاقی	اخلاقی	تان
زایدش	زاید	زاید	ش
عزیزم	عزیز	عزیز	م
روزانه‌اش	روزانه	روزانه	اش
آمریکایی‌ام	آمریکایی	آمریکایی	ام
بی‌شمارم	بی‌شمار	بی‌شمار	م
خیالیتان	خیالی	خیالی	تان
بیمارش	بیمار	بیمار	ش
بزرگوارش	بزرگوار	بزرگوار	ش
خوبش	خوب	خوب	ش
جستجوگرم	جستجوگر	جستجوگر	م
تحصیلی‌ام	تحصیلی	تحصیلی	ام
وجودی‌ام	وجودی	وجودی	ام
متضادشان	متضاد	متضاد	شان
محبوبتان	محبوب	محبوب	تان
واقعی‌شان	واقعی	واقعی	شان
اقتصادیشان	اقتصادی	اقتصادی	شان
سفیدت	سفید	سفید	ت
روزانه‌اش	روزانه	روزانه	اش
تازه‌اش	تازه	تازه	اش
غریبش	غریب	غریب	ش
وادارشان	وادار	وادار	شان
مصرفی‌ام	مصرفی	مصرفی	ام
مهربانت	مهربان	مهربان	ت
خانوادگی‌شان	خانوادگی	خانوادگی	شان
کاریمان	کاری	کاری	مان
مختصرمان	مختصر	مختصر	مان
راستتان	راست	راست	تان
گیرایش	گیرا	گیرا	یش
ملیشان	ملی	ملی	شان
آموزشی‌ام	آموزشی	آموزشی	ام
بدمان	بد	بد	مان
خوبتان	خوب	خوب	تان
ذهنیمان	ذهنی	ذهنی	مان
بزرگوارتان	بزرگوار	بزرگوار	تان
شکسته‌ام	شکسته	شکسته	ام
شکسته‌ام	شکسته	شکسته	ام
نغزتان	نغز	نغز	تان
شریفشان	شریف	شریف	شان
بدشان	بد	بد	شان
نیکشان	نیک	نیک	شان
فکریشان	فکری	فکری	شان
ولایتیمان	ولایتی	ولایتی	مان
شبانه‌مان	شبانه	شبانه	مان
سابقم	سابق	سابق	م
ممنونت	ممنون	ممنون	ت
وفادارش	وفادار	وفادار	ش
عزیزش	عزیز	عزیز	ش
غمگنانه‌اش	غمگنانه	غمگنانه	اش
مزخرفتان	مزخرف	مزخرف	تان
دوکلاجه‌اش	دوکلاجه	دوکلاجه	اش
اشکبارت	اشکبار	اشکبار	ت
مردانه‌ات	مردانه	مردانه	ات
معصومت	معصوم	معصوم	ت
سپیدم	سپید	سپید	م
سفیدش	سفید	سفید	ش
گسترده‌ات	گسترده	گسترده	ات
مادیتان	مادی	مادی	تان
عزیزم	عزیز	عزیز	م
قدیمی‌اش	قدیمی	قدیمی	اش
بلندت	بلند	بلند	ت
قبلی‌اش	قبلی	قبلی	اش
نامثبتمان	نامثبت	نامثبت	مان
تمامش	تمام	تمام	ش
جدیدم	جدید	جدید	م
ویژه‌اش	ویژه	ویژه	اش
شخصیشان	شخصی	شخصی	شان
خوشم	خوش	خوش	م
محبوبش	محبوب	محبوب	ش
ساله‌اش	ساله	ساله	اش
اختصاصی‌ام	اختصاصی	اختصاصی	ام
مهیمنش	مهیمن	مهیمن	ش
آسمانیتان	آسمانی	آسمانی	تان
خصوصی‌ام	خصوصی	خصوصی	ام
شریفش	شریف	شریف	ش
نامحدودت	نامحدود	نامحدود	ت
شیرینت	شیرین	شیرین	ت
راستینمان	راستین	راستین	مان
مقدرش	مقدر	مقدر	ش
مقدرش	مقدر	مقدر	ش
محکمتان	محکم	محکم	تان
شریکش	شریک	شریک	ش
مبارکتان	مبارک	مبارک	تان
نقره‌ای‌ات	نقره‌ای	نقره‌ای	ات
روانش	روان	روان	ش
بی‌نظیرش	بی‌نظیر	بی‌نظیر	ش
کهنه‌ات	کهنه	کهنه	ات
قضایی‌مان	قضایی	قضایی	مان
عمیقم	عمیق	عمیق	م
الکتریکی‌اش	الکتریکی	الکتریکی	اش
زلالتان	زلال	زلال	تان
آینده‌مان	آینده	آینده	مان
کاریشان	کاری	کاری	شان
بدش	بد	بد	ش
متاعش	متاع	متاع	ش
دیرینه‌اش	دیرینه	دیرینه	اش
طاهرش	طاهر	طاهر	ش
موجودتان	موجود	موجود	تان
گنده‌اش	گنده	گنده	اش
نزدیکش	نزدیک	نزدیک	ش
سپیدم	سپید	سپید	م
بدش	بد	بد	ش
هسته‌ای‌اش	هسته‌ای	هسته‌ای	اش
همیشگی‌اش	همیشگی	همیشگی	اش
تمتعش	تمتع	تمتع	ش
ساله‌ام	ساله	ساله	ام
درازش	دراز	دراز	ش
قبلیمان	قبلی	قبلی	مان
کوچکم	کوچک	کوچک	م
درستش	درست	درست	ش
بیجایشان	بیجا	بیجا	یشان
ایمنی‌ام	ایمنی	ایمنی	ام
بدش	بد	بد	ش
کورش	کور	کور	ش
هنری‌اش	هنری	هنری	اش
قبلی‌ام	قبلی	قبلی	ام
تابستانیتان	تابستانی	تابستانی	تان
پرتوانت	پرتوان	پرتوان	ت
خوشش	خوش	خوش	ش
جوانم	جوان	جوان	م
شخصیتان	شخصی	شخصی	تان
جوگندمی‌اش	جوگندمی	جوگندمی	اش
بی‌انتهایش	بی‌انتها	بی‌انتها	یش
وحشتناکش	وحشتناک	وحشتناک	ش
سنگینم	سنگین	سنگین	م
